NO texture/turtle_north.xpm
SO texture/penguin_south.xpm
WE texture/orca_west.xpm
EA texture/seahorse_east.xpm

F 128,128,128
C 0,255,255

11111111111111111111111111111111111111
10000000000000000000000000000000000001
11111111111111111111111111111111111101
                                   101
11111111111111111111111111111111111101
10000000000000000000000000000000000001
10111111111111111111111111111111111111
101
10111111111111111111111111111111111111
10000000000000000000000000000000000001
11111111111111111111111111111111111101
                                   101
11111111111111111111111111111111111101
10000000000000000000000000000000000001
10111111111111111111111111111111111111
101
10111111111111111111111111111111111111
10000000000000000000000000000000000001
11111111111111111111111111111111111101
                                   1N1
11111111111111111111111111111111111111
