NO texture/turtle_north.png
SO texture/penguin_south.png
WE texture/orca_west.png
EA texture/seahorse_east.png
F 128,128,128
C 0,255,255

11111111111111111111111111111111111111
10000000000000000000000000000000000001
10000000000000000000000000000000000001
10000000000000000000000000000000000001
10000000000000000000000000000000000001
10000000000000000000000000000000000001
10000000000000000000000000000000000001
10000000000000000000000000000000000001
10000000000000000000000000000000000001
10000000000000000N00000000000000000001
10000000000000000000000000000000000001
11111111111111111111111111111111111111
