NO texture/turtle_north.png
SO texture/penguin_south.png
WE texture/orca_west.png
EA texture/seahorse_east.png
F 128,128,128
C 0,255,255

111111
1N0001
100001
100001
111111
