NO texture/turtle_north.xpm
SO texture/penguin_south.xpm
WE texture/orca_west.xpm
EA texture/seahorse_east.xpm
F 128,128,128
C 0,255,255

11111111 1111111 111111111111
11110111 1110101 101111010001
110000011101010111110111100111
10000000000000011010100100001
10000000000000001100000010001
11000000110101011100000010001
11110111111111011101010010001
11110111111111011100000010001
100000000011000001110111101111111
11111111101100000111000000N000001
        1001000000000000000000001
        1001000000000000000000001
        1011000001110000000000001
        1000000000010000000000001
        1111111111111111111111111
