NO texture/turtle_north.xpm
SO texture/penguin_south.xpm
WE texture/orca_west.xpm
EA texture/seahorse_east.xpm
F 128,128,128
C 0,255,255

                                        111111111
                                       10000000001
            11111111                  1000000000001      1111111111
           10000000111111111111111111100000010000001111111000000001
          1000000000000000000000000000000001110N0000000000000000001
          100000000111111111111011111100000010000001111111000000001
          1111011111          101     1000000000001      1111111001
             101         11111101111   10000000001              101
  1111111111 101  11111  10000000001    111000111        1111111101  
 1100000000111011110001  10000000001       101           1000000001  1111111
11000000000000000000001  10000000001       10111111      1111111101  10000001
 1100000000111011110001  11111111111       10000001            101111100000001
  1111111111 101  11111                    10111101            100000000000001
             101            111111         10100001            101111100000001
          1111011111        100001         10111111         111101   10000001
          1000000001111111  111001         101              100001   1111111
          1000000000000001  100001      111101111           101111
           100000001111101  101111     1000000001          1001
            11111111   1011110111111111000000000111111111110001
                       1000000000000000000000000000000000000001
                       1111111111111111000000000111111101110001
                                       1000000001  100001 10001
                                        111111111  111111 1111