NO texture/turtule_north.xpm
SO texture/penguin_south.xpm
WE texture/orca_west.xpm
EA texture/seahorse_east.xpm
F 220,100,0
C 60,30,40
11111111111
1000N001001
10000001001
10000000001
1000N000001
11111111111