NO std_wall_n.xpm
SO std_wall_n.xpm
WE std_wall_n.xpm
EA std_wall_n.xpm
F 200,200,0
C 225,30,0

11111111111111111111111111111111111111
10000000000000000000000000000000000001
10000000000000000000000000000000000001
100N0000000000000000000000000000000001
10000000000000000000000000000000000001
10000000000000000000000000000000000001
10000000000000000000000000000000000001
10000000000000000000000000000000000001
10000000000000000000000000000000000001
10000000000000000000000000000000000001
10000000000000000000000000000000000001
11111111111111111111111111111111111111
