NO std_wall_n.xpm
SO std_wall_n.xpm
WE std_wall_n.xpm
EA std_wall_n.xpm
F 128,128,128
C 0,255,255

        1111111111111111111111111
        1000000000010000000000001
        1011000001110000000000001
        1001000000000000000000001
11111111101100000111000000N000001
100000000011000001110111101111111
11110111111111011100000010001
11110111111111011101010010001
11000000110101011100000010001
10000000000000001100000010001
10000000000000011010100100001
110000011101010111110111100111
11110111 1110101 101111010001
11111111 1111111 111111111111
